10 10 10

---

#1.1
!1.2
M2.1
R1.2
B1.3
S1.3
E1.4
C1.5

---

@##########
@##########
@##########
@##########
@##########
@##########
@##########
@##########
@##########
@##########

---

@###!######
@#        #
@# R B S E#
@#        #
@!  M     !
@#        #
@#        #
@#    C   #
@#        #
@#        #

---

@##########
@#        #
@# R B S E#
@#        #
@#        #
@#        #
@#        #
@#    C   #
@#        #
@#        #

---

@##########
@#        #
@#        #
@#        #
@#        #
@#        #
@#        #
@#        #
@#        #
@#        #

---

@##########
@#        #
@#        #
@#        #
@#        #
@#        #
@#        #
@#        #
@#        #
@##########

---

@##########
@#        #
@#        #
@#        #
@#        #
@#        #
@#        #
@#        #
@#        #
@#        #

---

@##########
@#        #
@#        #
@#        #
@#        #
@#        #
@#        #
@#        #
@#        #
@#        #

---

@##########
@#        #
@#        #
@#        #
@#        #
@#        #
@#        #
@#        #
@#        #
@#        #


---

@##########
@#        #
@#        #
@#        #
@#        #
@#        #
@#        #
@#        #
@#        #
@#        #

---

@##########
@##########
@##########
@##########
@##########
@##########
@##########
@##########
@##########
@##########

---

